********************************
*                              *
*                              *
*                              *
*                              *
*                              *
*                              *
*                              *
*                              *
*                **            *
*                 **           *
*                  **          *
*                   **         *
*                    **        *
*                   **         *
*                  **          *
*                 **           *
*                **            *
*                              *
*                              *
*                              *
*                              *
*                              *
*                              *
*                              *
*                              *
*                              *
*                              *
*                              *
*                              *
*                              *
********************************
