********************************
*             *                *
*             *                *
*             *                *
*             *                *
*             *                *
*             *                *
*             *                *
*             *                *
*             *                *
*             *                *
*             *                *
*             *                *
*             *                *
*             *                *
*             *                *
*                              *
*                              *
*                              *
*                              *
*                              *
*                              *
*                              *
*                              *
*                              *
*                              *
*                              *
*                              *
*                              *
*                              *
*                              *
********************************