****************
*       *      *
*       *      *
*       *      *
*       *      *
*       *      *
*    ****      *
*              *
*              *
*              *
*  *******     *
*        *     *
*        *     *
*        *     *
*        *     *
****************