********************************
*                              *
*                              *
*                *             *
*                *             *
*                *             *
*                *             *
*                *             *
*                *             *
*                              *
*                              *
*           ****               *
*              **              *
*               **             *
*                **            *
*               **             *
*              **              *
*           ****               *
*                              *
*                              *
*                              *
*       ****************       *
*                              *
*                              *
*                              *
*                              *
*                              *
*                              *
*                              *
*                              *
*                              *
********************************