********************************
*                              *
*                              *
*                              *
*                              *
*                              *
*                              *
*                              *
*                              *
*                              *
*                              *
*                              *
*                              *
*                              *
*                              *
*                              *
*                              *
*                              *
*                              *
*                         **  **
*                         *    *
*               *         *    *
*               *         *    *
*               *         *    *
*             ********   **    *
*             *      *****     *
*             *          *     *
*   ***  ******          *     *
*             *                *
*                              *
*                        *     *
********************************