********************************
*                              *
*                              *
*                              *
*                              *
***** ******************** *****
**                          * **
***********  *** **** * ***** **
**                  *   * *   **
** * ************ *** *** * ****
** * *   *   *  * *       *   **
** * * * * *    * * ******* * **
** * * *   ***              * **
** *   * * * *   ********     **
**   * * * * *****   *  * * * **
** ***** * * *   * *    * * * **
** *     * *       * *  * * * **
***** **** * *   * * * **** * **
**      *  * ***** *    *   * **
** * ***** *   * * *** ** * * **
** *    *  * *   *   *  * * * **
** * ***** ***** ***** ** *** **
** * *     * * *   * *  *   * **
** * *  *      * * *      * * **
**** ***** * ***** **** ***** **
**   *  *  *         *  *     **
*** ************************ ***
*                              *
*                              *
*                              *
*                              *
********************************
